##########
#H..#....#
#.#..#M..#
#........#
#.#.T..#.#
#.#....#.#
#.###....#
#........##
#.M..#.T.   <-End
###########