###############
#H....T...#...#
#.#..#..#..M..#
#M.#.....#....#
#...#..#.###.##
#.#....#...##.#
#T.#.#...#....#
#...#..#...#..##
#.#....#..M...  <-End
################