###############
#H..#.....#..M#
#.#.##.#......#
#...#...##....#
#.T..#.....#.##
#..#....#..#..#
#.#.##..##.##.#
#..##....#T#..##
#..M.##..#..M.  <-End
################